20 7
0 18
6 12
XXXXXXXXXXXXXXXXXX X
X             XXXX X
X XXXXXXXXXXX   XX X
X XXXXX XXXXXXX XX X
X            XX XX X
X XXXXXXXXXX XX    X
XXXXXXXXXXXX XXXXXXX